1 1
WWWWW
WFPFW
WFGFW
WFFFW
WWWWW